1111111111111
1N010000000C1
1000011111001
100P11E0000N1
1111111111111