1111111111111111111111111111111111
10000000000000000000000100N1000001
10P000000000N0000000000000C1000001
1000000000000000000000011111000001
10000C0000000000000000000000000001
1000000000000100000000000000000001
1000000000000100000000000000000001
1000000000000111111111110000N00001
100000000C000000000000010000000001
1000000000000001111111111111111111
10000000000000000000000000000C0001
1000000000000000000000000000000001
1000000C00000000000000000000000E01
1000000000000000000000000000000001
1111111111111111111111111111111111